//MAP CONVERTED BY dmm2tgm.py THIS HEADER COMMENT PREVENTS RECONVERSION, DO NOT REMOVE
"a" = (
/turf/open/floor/almayer{
	icon_state = "plate";
	tag = "icon-sterile"
	},
/area/shuttle/almayer_elevator)
"j" = (
/turf/open/floor/plating/plating_catwalk,
/area/shuttle/almayer_elevator)

(1,1,1) = {"
a
a
a
"}
(2,1,1) = {"
a
j
a
"}
(3,1,1) = {"
a
a
a
"}
