"a" = (/turf/open/space/basic,/area/space)
"g" = (/obj/item/reagent_container/glass/bucket,/turf/open/space/basic,/area/space)

(1,1,1) = {"
aaaaaaaaaa
aaaaaaaaaa
aaaaaaaaaa
gaaaaaaaaa
aaaaaaaaaa
aaaaaaaaaa
aaaaaaaaaa
"}
