"a" = (/turf/open/floor/plating/kutjevo,/area/kutjevo/interior/complex/botany)
"t" = (/turf/open/floor/kutjevo/colors/green,/area/kutjevo/interior/complex/botany)
"B" = (/turf/open/floor/kutjevo/tan,/area/kutjevo/interior/complex/botany)
"M" = (/obj/item/reagent_container/glass/bucket,/turf/open/floor/kutjevo/tan,/area/kutjevo/interior/complex/botany)
"Q" = (/obj/item/storage/bag/plants,/turf/open/floor/kutjevo/tan,/area/kutjevo/interior/complex/botany)
"T" = (/obj/item/storage/bag/plants,/turf/open/floor/plating/kutjevo,/area/kutjevo/interior/complex/botany)
"U" = (/turf/open/floor/greengrid,/area/kutjevo/interior/complex/botany)

(1,1,1) = {"
aaBBBBBBBB
MattBBtttB
BaUBTaBUMB
BtttBMtttB
QBUBBBBUBB
BtttQMtttB
BBBBBBBBBQ
"}
